AAAA:23232
BBBB:23232
CCCC:23232
DDDD:45587
EEEE:45874
student:12345
FFFF:54788
ABCD:123
EFGH:321
